03 03 03 03 03 03 02 00 03 03 
03 03 03 03 03 01 03 03 03 03 
03 03 02 03 00 03 03 03 03 03 
02 03 03 02 02 01 00 03 03 03 
02 03 03 03 02 01 03 03 03 02 
03 03 03 03 03 03 03 03 03 03 
03 00 03 03 00 03 01 02 02 03 
01 03 03 01 00 03 03 03 03 02 
