03 03 01 03 03 01 03 03 03 03 
03 03 03 03 03 02 03 03 03 03 
03 03 03 03 03 03 01 03 03 03 
03 03 03 03 01 01 03 03 03 03 
03 03 03 00 03 03 01 03 03 03 
03 01 03 03 03 03 02 03 03 03 
03 03 03 03 03 03 03 03 03 03 
03 03 03 03 03 02 00 03 03 00 
