03 03 03 03 03 03 03 03 03 03 03 03 03 03 03 
03 03 00 03 03 02 03 03 03 02 03 03 00 03 03 
03 03 03 03 03 02 03 03 03 02 03 03 03 03 03 
03 03 00 03 03 00 03 03 02 02 03 03 03 02 00 
00 03 03 03 03 01 03 03 03 03 03 03 03 03 00 
03 03 03 03 03 03 03 00 03 00 03 03 03 03 03 
03 03 03 03 03 00 03 03 03 03 00 02 02 03 02 
02 03 02 03 03 03 03 03 03 00 02 02 03 03 00 
00 03 03 03 03 03 03 03 03 03 03 02 03 03 03 
03 03 03 03 03 03 00 03 03 03 00 02 03 03 02 
02 03 03 03 02 03 03 03 03 02 02 00 03 02 03 
00 03 02 02 03 03 03 02 03 03 03 00 03 02 03 
